3
3 3 2
1 2
1 1 1 1 1 1 1 1 1 1 1 1 1 1 1 1 1 1 1 1 1 1 1 1
1 3
3 3 3 3 3 3 3 3 3 3 3 3 3 3 3 3 3 3 3 3 3 3 3 3 
2 3
1 1 1 1 1 1 1 1 1 1 1 1 1 1 1 1 1 1 1 1 1 1 1 1
2 1
3 3
3 1 2
1 2
1 1 1 1 1 1 1 1 1 1 1 1 1 1 1 1 1 1 1 1 1 1 1 1
2 2
3 4
3 3 3
1 2
7 23 23 25 26 26 25 24 23 22 21 20 19 18 17 16 15 14 13 12 11 10 9 8
1 3
10 11 15 26 30 29 28 27 26 25 24 23 22 21 20 19 18 17 16 15 14 13 12 11
2 3
7 29 28 27 26 26 25 24 23 22 21 20 19 18 17 16 15 14 13 12 11 10 9 8
2 14
3 3
3 21