2
3
1 2 5
3 6 1
12 2 7
5
0 0 0 0 0
1 1 1 1 0
2 2 2 8 0
1 1 1 0 0
0 0 0 0 0
