2
2
0 3 0 2 10 2 3 -2
10 3 2 3 8 7 2 0
3
1 2 0 5 10 2 8 0
0 3 0 1 7 1 2 2
3 3 0 5 1 1 4 0
