2
6 7 2
1111111
1122271
1211521
1329131
1242121
1122211
3 3 7
123
234
345
