4
2 3
...
...
2 3
x.x
xxx
2 3
x.x
x.x
10 10
....x.....
..........
..........
..x.......
..........
x...x.x...
.........x
...x......
........x.
.x...x....
