2
7 5
#####
##0##
##1.#
##2##
#3..#
#.#.#
#####
7 6
######
##...#
#..#.#
#...##
#0#..#
####1#
######
