2
4 4 0 0 5
0.8000 0.2000
. . . .
. . . .
. . A .
. A . A
10 10 9 1 4
0.6121 0.1000
. . A A . . . . . .
A . . . . . . . . .
. . A . . . . A . .
. . . A A . . . . .
. A A A . . . . . A
A . A A . . . . A .
. A . . . . . A . .
. . . . A A . . . .
. . A . . . A . . A
. . . . A . . A . .