Case #1: POSSIBLE
#############
#S..#..##...#
###.##..#.#F#
#...##.##.#.#
#.#.........#
#############
Case #2: IMPOSSIBLE
Case #3: POSSIBLE
##########
#S#...#.F#
#...#...##
##########
