6
3 3 1
###
#X#
###
3 3 2
###
#X#
###
4 3 8
###
#X#
#.#
###
7 7 4
#######
#.....#
#.....#
#..X..#
#....##
#.....#
#######
5 6 3
######
#..X.#
#.#..#
#...##
######
5 6 10
######
#..X.#
#.#..#
#...##
######
