3
08:00:00
09:00:00
18:00:00
22:00:00
12:00:00
100
08:00:00
09:00:00
18:00:00
22:00:00
01:00:00
1
00:00:00
12:00:00
12:00:01
23:59:59
00:00:02
2