2
5 5
3 1 4 1 5 9
2 7 1 8 2 9
4 8 15 16 23 42
1 2
0 0 0 0 0 1
0 0 0 0 0 1
0 1 0 0 0 2
